date_reported,country,new_cases,cumulative_cases,new_deaths,cumulative_deaths
3/8/2020,Bangladesh,7,7,0,0
3/9/2020,Bangladesh,0,7,0,0
3/10/2020,Bangladesh,0,7,0,0
3/11/2020,Bangladesh,0,7,0,0
3/12/2020,Bangladesh,0,7,0,0
3/13/2020,Bangladesh,0,7,0,0
3/14/2020,Bangladesh,0,7,0,0
3/15/2020,Bangladesh,0,7,0,0
3/16/2020,Bangladesh,5,12,0,0
3/17/2020,Bangladesh,0,12,0,0
3/18/2020,Bangladesh,2,14,0,0
3/19/2020,Bangladesh,3,17,1,1
3/20/2020,Bangladesh,0,17,0,1
3/21/2020,Bangladesh,7,24,1,2
3/22/2020,Bangladesh,0,24,0,2
3/23/2020,Bangladesh,3,27,0,2
3/24/2020,Bangladesh,12,39,2,4
3/25/2020,Bangladesh,0,39,0,4
3/26/2020,Bangladesh,5,44,1,5
3/27/2020,Bangladesh,4,48,0,5
3/28/2020,Bangladesh,0,48,0,5
3/29/2020,Bangladesh,0,48,0,5
3/30/2020,Bangladesh,1,49,0,5
3/31/2020,Bangladesh,0,49,0,5
4/1/2020,Bangladesh,5,54,1,6
4/2/2020,Bangladesh,2,56,0,6
4/3/2020,Bangladesh,5,61,0,6
4/4/2020,Bangladesh,9,70,2,8
4/5/2020,Bangladesh,18,88,0,8
4/6/2020,Bangladesh,35,123,4,12
4/7/2020,Bangladesh,41,164,5,17
4/8/2020,Bangladesh,54,218,3,20
4/9/2020,Bangladesh,112,330,1,21
4/10/2020,Bangladesh,94,424,6,27
4/11/2020,Bangladesh,58,482,3,30
4/12/2020,Bangladesh,139,621,4,34
4/13/2020,Bangladesh,182,803,5,39
4/14/2020,Bangladesh,209,1012,7,46
4/15/2020,Bangladesh,219,1231,4,50
4/16/2020,Bangladesh,341,1572,10,60
4/17/2020,Bangladesh,266,1838,15,75
4/18/2020,Bangladesh,306,2144,9,84
4/19/2020,Bangladesh,312,2456,7,91
4/20/2020,Bangladesh,492,2948,10,101
4/21/2020,Bangladesh,434,3382,9,110
4/22/2020,Bangladesh,390,3772,10,120
4/23/2020,Bangladesh,414,4186,7,127
4/24/2020,Bangladesh,503,4689,4,131
4/25/2020,Bangladesh,309,4998,9,140
4/26/2020,Bangladesh,418,5416,5,145
4/27/2020,Bangladesh,497,5913,7,152
4/28/2020,Bangladesh,549,6462,3,155
4/29/2020,Bangladesh,641,7103,8,163
4/30/2020,Bangladesh,564,7667,5,168
5/1/2020,Bangladesh,571,8238,2,170
5/2/2020,Bangladesh,552,8790,5,175
5/3/2020,Bangladesh,665,9455,2,177
5/4/2020,Bangladesh,688,10143,5,182
5/5/2020,Bangladesh,786,10929,1,183
5/6/2020,Bangladesh,790,11719,3,186
5/7/2020,Bangladesh,706,12425,0,186
5/8/2020,Bangladesh,709,13134,20,206
5/9/2020,Bangladesh,636,13770,8,214
5/10/2020,Bangladesh,887,14657,14,228
5/11/2020,Bangladesh,1034,15691,11,239
5/12/2020,Bangladesh,969,16660,11,250
5/13/2020,Bangladesh,1162,17822,19,269
5/14/2020,Bangladesh,1041,18863,14,283
5/15/2020,Bangladesh,1202,20065,15,298
5/16/2020,Bangladesh,930,20995,16,314
5/17/2020,Bangladesh,0,20995,0,314
5/18/2020,Bangladesh,2875,23870,35,349
5/19/2020,Bangladesh,1251,25121,21,370
5/20/2020,Bangladesh,1617,26738,16,386
5/21/2020,Bangladesh,1773,28511,22,408
5/22/2020,Bangladesh,1694,30205,24,432
5/23/2020,Bangladesh,1873,32078,20,452
5/24/2020,Bangladesh,1532,33610,28,480
5/25/2020,Bangladesh,1975,35585,21,501
5/26/2020,Bangladesh,1166,36751,21,522
5/27/2020,Bangladesh,1541,38292,22,544
5/28/2020,Bangladesh,2029,40321,15,559
5/29/2020,Bangladesh,2523,42844,23,582
5/30/2020,Bangladesh,1764,44608,28,610
5/31/2020,Bangladesh,2545,47153,40,650
6/1/2020,Bangladesh,0,47153,0,650
6/2/2020,Bangladesh,2381,49534,22,672
6/3/2020,Bangladesh,2911,52445,37,709
6/4/2020,Bangladesh,2695,55140,37,746
6/5/2020,Bangladesh,2423,57563,35,781
6/6/2020,Bangladesh,2828,60391,30,811
6/7/2020,Bangladesh,2635,63026,35,846
6/8/2020,Bangladesh,2743,65769,42,888
6/9/2020,Bangladesh,2735,68504,42,930
6/10/2020,Bangladesh,3171,71675,45,975
6/11/2020,Bangladesh,3190,74865,37,1012
6/12/2020,Bangladesh,3187,78052,37,1049
6/13/2020,Bangladesh,3471,81523,46,1095
6/14/2020,Bangladesh,2856,84379,44,1139
6/15/2020,Bangladesh,3141,87520,32,1171
6/16/2020,Bangladesh,3099,90619,38,1209
6/17/2020,Bangladesh,3862,94481,53,1262
6/18/2020,Bangladesh,4008,98489,43,1305
6/19/2020,Bangladesh,3803,102292,38,1343
6/20/2020,Bangladesh,3243,105535,45,1388
6/21/2020,Bangladesh,3240,108775,37,1425
6/22/2020,Bangladesh,3531,112306,39,1464
6/23/2020,Bangladesh,3480,115786,38,1502
6/24/2020,Bangladesh,3412,119198,43,1545
6/25/2020,Bangladesh,3462,122660,37,1582
6/26/2020,Bangladesh,3946,126606,39,1621
6/27/2020,Bangladesh,3868,130474,40,1661
6/28/2020,Bangladesh,3504,133978,34,1695
6/29/2020,Bangladesh,3809,137787,43,1738
6/30/2020,Bangladesh,4014,141801,45,1783
7/1/2020,Bangladesh,3682,145483,64,1847
7/2/2020,Bangladesh,3775,149258,41,1888
7/3/2020,Bangladesh,4019,153277,38,1926
7/4/2020,Bangladesh,3114,156391,42,1968
7/5/2020,Bangladesh,3288,159679,29,1997
7/6/2020,Bangladesh,2738,162417,55,2052
7/7/2020,Bangladesh,3201,165618,44,2096
7/8/2020,Bangladesh,3027,168645,55,2151
7/9/2020,Bangladesh,3489,172134,46,2197
7/10/2020,Bangladesh,3360,175494,41,2238
7/11/2020,Bangladesh,2949,178443,37,2275
7/12/2020,Bangladesh,2686,181129,30,2305
7/13/2020,Bangladesh,2666,183795,47,2352
7/14/2020,Bangladesh,3099,186894,39,2391
7/15/2020,Bangladesh,3163,190057,33,2424
7/16/2020,Bangladesh,3533,193590,33,2457
7/17/2020,Bangladesh,2733,196323,39,2496
7/18/2020,Bangladesh,3034,199357,51,2547
7/19/2020,Bangladesh,2709,202066,34,2581
7/20/2020,Bangladesh,2459,204525,37,2618
7/21/2020,Bangladesh,2928,207453,50,2668
7/22/2020,Bangladesh,3057,210510,41,2709
7/23/2020,Bangladesh,2744,213254,42,2751
7/24/2020,Bangladesh,2856,216110,50,2801
7/25/2020,Bangladesh,2548,218658,35,2836
7/26/2020,Bangladesh,2520,221178,38,2874
7/27/2020,Bangladesh,2275,223453,54,2928
7/28/2020,Bangladesh,2772,226225,37,2965
7/29/2020,Bangladesh,2960,229185,35,3000
7/30/2020,Bangladesh,3009,232194,35,3035
7/31/2020,Bangladesh,2695,234889,48,3083
8/1/2020,Bangladesh,2772,237661,28,3111
8/2/2020,Bangladesh,2199,239860,21,3132
8/3/2020,Bangladesh,886,240746,22,3154
8/4/2020,Bangladesh,1356,242102,30,3184
8/5/2020,Bangladesh,1918,244020,50,3234
8/6/2020,Bangladesh,2654,246674,33,3267
8/7/2020,Bangladesh,2977,249651,39,3306
8/8/2020,Bangladesh,2851,252502,27,3333
8/9/2020,Bangladesh,2611,255113,32,3365
8/10/2020,Bangladesh,2487,257600,34,3399
8/11/2020,Bangladesh,2907,260507,39,3438
8/12/2020,Bangladesh,2996,263503,33,3471
8/13/2020,Bangladesh,2995,266498,42,3513
8/14/2020,Bangladesh,2617,269115,44,3557
8/15/2020,Bangladesh,2766,271881,34,3591
8/16/2020,Bangladesh,2644,274525,34,3625
8/17/2020,Bangladesh,2024,276549,32,3657
8/18/2020,Bangladesh,2595,279144,37,3694
8/19/2020,Bangladesh,3200,282344,46,3740
8/20/2020,Bangladesh,2747,285091,41,3781
8/21/2020,Bangladesh,2868,287959,41,3822
8/22/2020,Bangladesh,2401,290360,39,3861
8/23/2020,Bangladesh,2265,292625,46,3907
8/24/2020,Bangladesh,1973,294598,34,3941
8/25/2020,Bangladesh,2485,297083,42,3983
8/26/2020,Bangladesh,2545,299628,45,4028
8/27/2020,Bangladesh,2519,302147,54,4082
8/28/2020,Bangladesh,2436,304583,45,4127
8/29/2020,Bangladesh,2211,306794,47,4174
8/30/2020,Bangladesh,2131,308925,32,4206
8/31/2020,Bangladesh,1897,310822,42,4248
9/1/2020,Bangladesh,2174,312996,33,4281
9/2/2020,Bangladesh,1950,314946,35,4316
9/3/2020,Bangladesh,2582,317528,35,4351
9/4/2020,Bangladesh,2158,319686,32,4383
9/5/2020,Bangladesh,1929,321615,29,4412
9/6/2020,Bangladesh,1950,323565,35,4447
9/7/2020,Bangladesh,1592,325157,32,4479
9/8/2020,Bangladesh,2202,327359,37,4516
9/9/2020,Bangladesh,1892,329251,36,4552
9/10/2020,Bangladesh,1827,331078,41,4593
9/11/2020,Bangladesh,1892,332970,41,4634
9/12/2020,Bangladesh,1792,334762,34,4668
9/13/2020,Bangladesh,1282,336044,34,4702
9/14/2020,Bangladesh,1476,337520,31,4733
9/15/2020,Bangladesh,1812,339332,26,4759
9/16/2020,Bangladesh,1724,341056,43,4802
9/17/2020,Bangladesh,1615,342671,21,4823
9/18/2020,Bangladesh,1593,344264,36,4859
9/19/2020,Bangladesh,1541,345805,22,4881
9/20/2020,Bangladesh,1567,347372,32,4913
9/21/2020,Bangladesh,1544,348916,26,4939
9/22/2020,Bangladesh,1705,350621,40,4979
9/23/2020,Bangladesh,1557,352178,28,5007
9/24/2020,Bangladesh,1666,353844,37,5044
9/25/2020,Bangladesh,1540,355384,28,5072
9/26/2020,Bangladesh,1383,356767,21,5093
9/27/2020,Bangladesh,1106,357873,36,5129
9/28/2020,Bangladesh,1275,359148,32,5161
9/29/2020,Bangladesh,1407,360555,32,5193
9/30/2020,Bangladesh,1488,362043,26,5219
10/1/2020,Bangladesh,1436,363479,32,5251
10/2/2020,Bangladesh,1508,364987,21,5272
10/3/2020,Bangladesh,1396,366383,33,5305
10/4/2020,Bangladesh,1182,367565,20,5325
10/5/2020,Bangladesh,1125,368690,23,5348
10/6/2020,Bangladesh,1442,370132,27,5375
10/7/2020,Bangladesh,1499,371631,30,5405
10/8/2020,Bangladesh,1520,373151,35,5440
10/9/2020,Bangladesh,1441,374592,20,5460
10/10/2020,Bangladesh,1278,375870,17,5477
10/11/2020,Bangladesh,1203,377073,23,5500
10/12/2020,Bangladesh,1193,378266,24,5524
10/13/2020,Bangladesh,1472,379738,31,5555
10/14/2020,Bangladesh,1537,381275,22,5577
10/15/2020,Bangladesh,1684,382959,16,5593
10/16/2020,Bangladesh,1600,384559,15,5608
10/17/2020,Bangladesh,1527,386086,15,5623
10/18/2020,Bangladesh,1209,387295,23,5646
10/19/2020,Bangladesh,1274,388569,14,5660
10/20/2020,Bangladesh,1637,390206,21,5681
10/21/2020,Bangladesh,1380,391586,18,5699
10/22/2020,Bangladesh,1545,393131,24,5723
10/23/2020,Bangladesh,1696,394827,24,5747
10/24/2020,Bangladesh,1586,396413,14,5761
10/25/2020,Bangladesh,1094,397507,19,5780
10/26/2020,Bangladesh,1308,398815,23,5803
10/27/2020,Bangladesh,1436,400251,15,5818
10/28/2020,Bangladesh,1335,401586,20,5838
10/29/2020,Bangladesh,1493,403079,23,5861
10/30/2020,Bangladesh,1681,404760,25,5886
10/31/2020,Bangladesh,1604,406364,19,5905
11/1/2020,Bangladesh,1320,407684,18,5923
11/2/2020,Bangladesh,1568,409252,18,5941
11/3/2020,Bangladesh,1736,410988,25,5966
11/4/2020,Bangladesh,1659,412647,17,5983
11/5/2020,Bangladesh,1517,414164,21,6004
11/6/2020,Bangladesh,1842,416006,17,6021
11/7/2020,Bangladesh,1469,417475,15,6036
11/8/2020,Bangladesh,1289,418764,13,6049
11/9/2020,Bangladesh,1474,420238,18,6067
11/10/2020,Bangladesh,1683,421921,25,6092
11/11/2020,Bangladesh,1699,423620,16,6108
11/12/2020,Bangladesh,1733,425353,19,6127
11/13/2020,Bangladesh,1845,427198,13,6140
11/14/2020,Bangladesh,1767,428965,19,6159
11/15/2020,Bangladesh,1531,430496,14,6173
11/16/2020,Bangladesh,1837,432333,21,6194
11/17/2020,Bangladesh,2139,434472,21,6215
